WWWWWWWWWWWWWWWWWWWWW
WWWW00000WWW00000WWWW
W0000WWW00000WWW0000W
WG0000WW12000WW0000GW
WG0000WW34P56WW0000GW
WG0W0000000780000W0GW
WG000WWW00000WWW000GW
WWWWWWWWW0J0WWWWWWWWW
WWWWWWWWWWWWWWWWWWWWW