WWWWWWWWWWWWWWWWW
WWWWWGGWGWGWWWWWW
WWWWW00W0W0WWWWWW
WWWW000W000WW000W
W0P00123400000J0W
WWWW00W000WWW000W
WWWWWWWWWWWWWWWWW