WWWWWWWWWWWWWWWWWWWWW
W0000000000000000000W
W0000000000000000000W
W0000000000000000000W
W000000GGWGG00000000W
W0000000GGG000000000W
W00000110W0000000000W
W0000010000002200000W
W00000100P0022000000W
W0000110000002200000W
W0000000000000000000W
WWWWWWWWWWWWWWWWWWWWW