WWWWWWWWWWWWWWWWWWWW
WWWWWWWWWWWWWWWW000W
WWWWW000W0000WWW001W
WG00000000000011111W
WW0000000000000100PW
WWW00000W00000WWWWWW
WWWWWWWWWWWWWWWWWWWW
WWWWWWWWWWWWWWWWWWWW