00000000000G0
0000000000500
0001111111000
0001000001000
000100P001000
000100W30140G
000100J001000
0001000201000
0001111111000
00000G00GG000
0000G00G00000