WWWWWWWWWWWWWWWWWWWW
W111000222000000GGGW
W1P1000202000000G0GW
W111000222000000GGGW
W000000WWWWWWWWWWWWW
W000000000WWWWWWWWWW
W000000000000WWWWWWW
WWWW000000000000000W
WWWWWWW0000000000J0W
WWWWWWWWWW000000000W
WWWWWWWWWWWWWWWWWWWW