WWWWWWWWWWWWWWWWWWWWW
WWWWWWWWWWW00000000JW
WWWWWWWWWWW000110000W
WWWWWWWWWWWWWW100000W
WWWWWWWWWW0000100000W
WWWWWWWWWW00001WWWWWW
WWWWW00000P001100000W
WWWWW0000W00000W0000W
WWWWW00333W0000W0000W
WWWWW00W0300220W0000W
WWWWW000030002222000W
WWWWWWWWWWWWWWWWWWWWW