WWWWWWWWWWWWWWWWWW
W0000000000000000W
W0000000000000000W
W0000001111000000W
W0222001111003330W
W0222000000003330W
W0000000000000000W
W0004440000555000W
W0000000P00000000W
W0000000000000000W
WWWWWWWWWWWWWWWWWW