WWWWWWWWWWW
W000000000W
W0000G0200W
W0100G0220W
W0110G0020W
W0010G0000W
W0000P0000W
WWWWWWWWWWW