WWWWWWWWW
W00G0G00W
W0000000W
W0100020W
W000G000W
W00WWW00W
W0WWWWW0W
W000P000W
WWWWWWWWW