WWWWWWWWW
W00G0G00W
W0010100W
W0011100W
W0001000W
W0000000W
W00WWW00W
W000P000W
WWWWWWWWW