WWWWWWWWWWW
WWW00000WWW
W000W1W000W
W000203000W
W000W0W000W
WWWWW0WWWWW
WWWW000WWWW
WWWW0PGWWWW
WWWWG0GWWWW
WWWW0J0WWWW
WWWWWWWWWWW