WWWWWWWWWWW
WWWWWWWW00W
W000000000W
W0120WW0G0W
WWWW000WGWW
WWWW0P0WWWW
WWWW000WWWW
WWWWWWWWWWW