WWWWWWWWWWWWWWWWWWW
WWWWW000WWW000WWWWW
W00001G00P00G20000W
W000WWWWWWWWWWW000W
WWWWWWWWWWWWWWWWWWW